40 40
0000000000000000000000000000000000000000
0000000000000000000000000000000000000000
0000000000000000000000000000000000000000
0000000000000000000000000000000000000000
0000000000000000000000000000000000000000
0000000000000000000000000000000000000000
0000000000000000000000000000000000000000
0000000000000000000000000000000000000000
0000000000000000000000000000000000000000
0000000000000000002222222220000000000001
0000000000002222222222222222200000000111
0000000000222222222222222222200000001111
0000000000222222222222222222220000001111
0000000002222222222222222222220000001111
0000000002222222222222222222220000011111
0000000002222222222222222222220000011111
0000000022222222222222222222220000011111
0000000022222222222222222222200000011111
0000000022222222222222222222200000011111
0000000022222222222222222222200000011111
0000000022222222222222222222200000011111
0000000002222222222222222222200000011111
0000000002222222222222222222200000011111
0000000002222222222222222222200000011111
0000000000222222222222222222000000111111
0000000000222222222222222220000000111111
0000000000022222222222222200000000111111
0000000000000222200000000000000001111111
0000000000000000000000000000000001111111
0000000000000000000000000000000001111111
0000000000000000000000000000000001111111
0000000000000000000000000000000001111111
0000000000000000000000000000000111111111
0000000000000000000000000000011111111111
0000000000000000000000001111111111111111
0000000000000000000000111111111111111111
0000000000000000000011111111111111111111
0000000000000000000011111111111111111111
0000000000000000000111111111111111111111
0000000000000000000111111111111111111111
