40 40
0000000000000000000000000000000000000000
0000000000000000000000000000000000000000
0000000000000000000000000000000000000000
0002222222222222222222222222222222220000
0002000000000000000000000000000000002000
0002000000000000000000000000000000002000
0002000000000000000000000000000000002000
0002000222222222222222222222222222222000
0002000000000000000000000000000000002000
0002000000000000000000000000000000002000
0002000000000000000000000000000000002000
0002222222222222222222222222222000002000
0002000000000000000000000000002000002000
0002000000000000000000000000002000002000
0002000000000000000000000000002000002000
0002000000000000000000000000002000002000
0002000002200000000000000000002000002000
0002000002200000000000000000002000002000
0002222222222222222222222000002000002000
0002000002200000000000000000002000002000
0002000002200000000000000000002000002000
0002000000000000000000000000002000002000
0002000000000000000000000000000000002000
0002000000000000000000000000000000002000
0002000000000000000000000000000000002000
0002000000000000000000000000000000022000
0002000000002222222222222222222222222000
0002000000002200000000000000000000002000
0002000000002200000000000000000000002000
0002000000002200000000000000000000002000
0002000000002200000000000000000000002000
0002000000000000000000000000000000002000
0002000000000000000000000000000000002000
0002000000000000000000000000000000002000
0002000000000000000000000000000000002000
0002222222222222222222222200000000002000
0000000000000000000000000000000000002000
0000000000000000000000000000000000000000
0000000000000000000000000000000000000000
0000000000000000000000000000000000000000
